NO ./texture/wood.xpm
SO ./texture/greystone.xpm
WE ./texture/redbrick.xpm
EA ./texture/purplestone.xpm
F 220,100,0
C 225,30,0

111111111111111111111111
100000000000000000000001
100000000000011100001101
100000000000011100000001
100000000000000000000001
100011111111111110000001
100001111111111111000001
100001000000001100000011
1000010000N0001100000011
100001000000000100000001
100001000001111111101001
100000000000000000000001
100000000000000000000001
100000001100000000000001
100000000000000000000001
100000000000000000000001
101111000000000011000001
100000000000000000000001
100000001111111110000001
100000000000000000000001
100000000000000000000001
100000111110000010000001
100000000000000010000001
111111111111111111111111