NO ./texture/wood.xpm
SO ./texture/greystone.xpm
WE ./texture/redbrick.xpm
EA ./texture/purplestone.xpm
F 220,100,0
C 225,30,0

111111111111111111111111
100000000000000000000001
100000000000000000000001
100000000000000000000001
100000022220000303030001
100000200020000000000001
10000020002000030030001
100000200020000000000001
100000220220000303030001
100000000000000000000001
100000000000000000000001
100000000000000000000001
100000000000000000000001
100000000000000000000001
100000000000000000000001
100000000000000000000001
144444444000000000000001
140400000400000000000001
140000500400000000000001
140400000400000000000001
140444444400000000000001
140000000000000000000001
144444444000000000000001
111111111111111111111111