NO ./texture/wood.xpm
SO ./texture/greystone.xpm
WE ./texture/redbrick.xpm
EA ./texture/purplestone.xpm
F 220,100,0
C 225,30,0

111111111111111111111111
100000000000000000000001
100000000000000000000001
100000000000000000000001
100000011110001010300011
100000200020000000000001
100000200021100100300011
100000200020000000000001
100000111110000001110001
100000000000000000000001
100000000000000000000001
100000000000000000000001
100000000000000000000001
100000000000000000000001
100000000000000000000001
100000000000000000000001
111111111000000000000001
140400000100000000000001
140000110000000000000001
140400000400000000000001
140111111100000011111001
140000000000000000000001
144441114000000000000001
111111111111111111111111