NO ./texture/wood.xpm
SO ./texture/greystone.xpm
WE ./texture/redbrick.xpm
EA ./texture/eagle.xpm
F 00,153,15
C 255,255,255


11111111111111111111111111
1100000000000S000000000011
 110000000000000000000011
  1100000000000000000011
   11000000000000000011
    110000000000000011
     1100000000000011
      11000000000011
       110000000011
        1100000011
         11011011
          110011
           1111


