NO ./texture/wood.xpm
SO ./texture/greystone.xpm
WE ./texture/redbrick.xpm
EA ./texture/eagle.xpm
F 00,153,15
C 255,255,255

111111111111111111111111
100000000100000000000001
1000000N0000011100001101
100000000000011100000001
111111111111111111111111
