NO ./texture/wood.xpm
SO ./texture/greystone.xpm
WE ./texture/redbrick.xpm
EA ./texture/eagle.xpm
F 180,113,66
C 36,139,255

111111111111111111111111
100000000100000000000001
100000000000011100001101
1000010000N0001100000011
100000111110000010000001
100000000000000010000001
111111111111111111111111
