NO ./texture/wood.xpm
SO ./texture/greystone.xpm
WE ./texture/redbrick.xpm
EA ./texture/eagle.xpm
F 00,153,15
C 255,255,255

111111111111111111111111
1000000000000S0000000001
110000000000000000000011
111111111111111111111111
